.............h.T
.tt..........h..
..t....tt....h..
.1....tTt....h..
.............h.t
vvvvvvvvqvvvvL..
......tth.....tT
.....t..h......t
....TT..h......t
..t..Tt.h.......
..tt....h.......
..T.t...h.......
.....rvvL.Tt..2.
.....h..t.t.....
.....h....t.....
t....h..t.......
